XXXXXXXXX
X0000000X
X0000120X
X0120000X
X0022100X
X0000210X
X0000000X
XXXXXXXXX