XXXXXXXXXXXX
X2212121121X
X1221111222X
X2021210222X
X1122002121X
X1100121111X
X0001111020X
X2222000112X
X2112221200X
X0001122000X
X1211100222X
XXXXXXXXXXXX