XXXXXXXXXXXX
X0011120222X
X1222101112X
X1202120112X
X1222121102X
X0111102222X
X0220211101X
X2111212201X
X2011210221X
X2101212021X
X2022011110X
XXXXXXXXXXXX